0000000100001000000
0000000100001000000
0000000100001000000
0000100100001000000
0000100100000000001
1111100111000000000
0000000100000000000
0000000100011111000
0000001100000000000
0000001000100000001
1111101000000000001
0000000000000000000
0000000000000000000
1000100011111111111
0000101111010100000
0000100000100010110
0000111110111111100
0000100000000000000
0000100000000000000