000000000000000000000000000000000000000
000000000000000000000000000000000000000
000001000000100000000000000000000000000
000001000000100000000000000000000000000
011111111111111111111111111111111111100
010000000000000000000000000000000000000
010000000000000000000001100000000000000
010000000000000000000001100011111111100
010000000000000000000001100001111111100
011111111000000000000001100000111111100
011111110000000000000001100000011111100
011111100001111111110001100000001111100
011111000001111111110001100000000111100
011110000001111111110001100000000011100
011100000001111111110001100000000001100
000111100000000000010001100000000000110
000111100000000000010001100000000000010
000111100000000000010001100000000000010
000000000000000000010001100000001100010
000000000000000000010001100000111111010
000000000000000000010000000000111111010
011111000000000000010000000000001100010
011001111100000000010000000000001100010
011001111000000000011111111111111111010
011001110000000000011111000000001100010
011001100000000000011110000000001100010
011001000000000000011100000000001100010
011000001000000000011000000000001100010
011000000100000000010000001110001100010
011000000110000000010000011110001100010
011000000011000000010000111111000000010
011000000011100000010000111111000000010
011000000011110000010000111111000000010
011000111111111000010000111111111111110
011000000000000000010000000111111111110
011000000000000000010000000000000000010
011111111111111111111111111111111111110
000000000000000000000000000000000000000
000000000000000000000000000000000000000